

log_e	KEYWORD1
log_w	KEYWORD1
log_i	KEYWORD1
log_d	KEYWORD1
log_v	KEYWORD1
ble_calloc	KEYWORD1
configTzTime	KEYWORD1
getLocalTime	KEYWORD1
heap_caps_get_free_size	KEYWORD1
getFreePsram	KEYWORD1
rtc_get_reset_reason	KEYWORD1
xSemaphoreTake	KEYWORD1
xSemaphoreGive	KEYWORD1
esp_ota_get_running_partition	KEYWORD1
esp_ota_get_next_update_partition	KEYWORD1
freeheap	KEYWORD1
freepsheap	KEYWORD1
resetReason	KEYWORD1
ps_calloc	KEYWORD1
ps_malloc	KEYWORD1
WRITE_PERI_REG	KEYWORD1
xTaskCreatePinnedToCore	KEYWORD1
xSemaphoreCreateMutex	KEYWORD1
vTaskDelay	KEYWORD1
vTaskDelete	KEYWORD1
vTaskSuspend	KEYWORD1
ESP	KEYWORD1
BLEScanUtils	KEYWORD1
BLECollector	KEYWORD1
BLEDevHelper	KEYWORD1
BLEScanResults	KEYWORD1
BLEScan	KEYWORD1
BLE_FS	KEYWORD1
BLEAdvertisedDevice	KEYWORD1
BLECardThemes	KEYWORD1
BLECardTheme	KEYWORD1
HTTPClient	KEYWORD1
UI	KEYWORD1
DB	KEYWORD1
Out	KEYWORD1
tft	KEYWORD1
BLEDevice	KEYWORD1
BLECardStyle	KEYWORD1
RTC	KEYWORD1
preferences	KEYWORD1
DBUtils	KEYWORD1
DBMessage	KEYWORD1
DBName	KEYWORD1
VendorHeapCacheStruct	KEYWORD1
VendorPsramCacheStruct	KEYWORD1
OUIHeapCacheStruct	KEYWORD1
OUIPsramCacheStruct	KEYWORD1
FoundDeviceCallback	KEYWORD1
AmigaBall	KEYWORD1
TimeUpdateSources	KEYWORD1


sendRequest	KEYWORD2
GET	KEYWORD2
scan	KEYWORD2
BLEAdvertisedDeviceCallbacks	KEYWORD2
onResult	KEYWORD2
startScanTask	KEYWORD2
stopScanTask	KEYWORD2
startDumpTask	KEYWORD2
startSerialTask	KEYWORD2
serialTask	KEYWORD2
serialParseBuffer	KEYWORD2
dumpTask	KEYWORD2
scanTask	KEYWORD2
onAfterScanSteps	KEYWORD2
onScanPopulate	KEYWORD2
onScanIfExists	KEYWORD2
onScanRender	KEYWORD2
onScanPropagate	KEYWORD2
onBeforeScan	KEYWORD2
onAfterScan	KEYWORD2
getDeviceCacheIndex	KEYWORD2
dumpStats	KEYWORD2
populate	KEYWORD2
pruneDB	KEYWORD2
setMac	KEYWORD2
setAssignment	KEYWORD2
setBLEDBPath	KEYWORD2
cacheWarmup	KEYWORD2
cacheState	KEYWORD2
clean	KEYWORD2
deviceExists	KEYWORD2
loadVendorsToPSRam	KEYWORD2
loadOUIToPSRam	KEYWORD2
error	KEYWORD2
DBExec	KEYWORD2
insertBTDevice	KEYWORD2
getVendor	KEYWORD2
getOUI	KEYWORD2
showDataSamples	KEYWORD2
getEntries	KEYWORD2
createDB	KEYWORD2
dropDB	KEYWORD2
testVendorNames	KEYWORD2
testOUI	KEYWORD2
VendorHeapCacheSet	KEYWORD2
vendorHeapExists	KEYWORD2
getHeapVendor	KEYWORD2
vendorPsramExists	KEYWORD2
getPsramVendor	KEYWORD2
OUIHeapCacheSet	KEYWORD2
OUIHeapExists	KEYWORD2
getHeapOUI	KEYWORD2
OUIPsramExists	KEYWORD2
getPsramOUI	KEYWORD2
BLEDevDBCallback	KEYWORD2
VendorDBCallback	KEYWORD2
OUIDBCallback	KEYWORD2
DBCallback	KEYWORD2



SDSetup	KEYWORD2
getScan	KEYWORD2
resetTimeActivity	KEYWORD2
setAdvertisedDeviceCallbacks	KEYWORD2
setActiveScan	KEYWORD2
getAddress	KEYWORD2
toString	KEYWORD2
c_str	KEYWORD2
getRSSI	KEYWORD2
haveName	KEYWORD2
haveAppearance	KEYWORD2
getAppearance	KEYWORD2
haveManufacturerData	KEYWORD2
getManufacturerData	KEYWORD2
getServiceUUID	KEYWORD2
copy	KEYWORD2
parseBuffer	KEYWORD2
getPartitionBuildSignature	KEYWORD2
getBinarySignature	KEYWORD2
doUpdateToFS	KEYWORD2
getSignature	KEYWORD2
updateToFS	KEYWORD2
rollBackOrUpdateFromFS	KEYWORD2
performUpdate	KEYWORD2
takeMuxSemaphore	KEYWORD2
giveMuxSemaphore	KEYWORD2
logTimeActivity	KEYWORD2
resetTimeActivity	KEYWORD2
getTimeActivity	KEYWORD2
updateTimeString	KEYWORD2
gettimeofday	KEYWORD2
RTCSetup	KEYWORD2
timeSetup	KEYWORD2
wget	KEYWORD2
getRemoteFileSize	KEYWORD2
sudoMakeMeASandwich	KEYWORD2
WiFiConnect	KEYWORD2
WiFi_Begin	KEYWORD2
btStop	KEYWORD2
drawJpg	KEYWORD2
cacheStats	KEYWORD2
alignTextAt	KEYWORD2
address	KEYWORD2
ouiname	KEYWORD2
manufname	KEYWORD2
uuid	KEYWORD2
manufid	KEYWORD2
appearance	KEYWORD2
rssi	KEYWORD2
created_at	KEYWORD2
updated_at	KEYWORD2
hits	KEYWORD2
in_db	KEYWORD2
is_anonymous	KEYWORD2
addr_type	KEYWORD2
devid	KEYWORD2
vendor	KEYWORD2
mac	KEYWORD2
assignment	KEYWORD2
HOBO	KEYWORD2
ROGUE	KEYWORD2
CHRONOMANIAC	KEYWORD2
NTP_MENU	KEYWORD2
sqlite3_initialize	KEYWORD2
sqlite3_free	KEYWORD2
resetDB	KEYWORD2
canRollBack	KEYWORD2
rollBack	KEYWORD2
isFinished	KEYWORD2
getTextBounds	KEYWORD2
scroll_slow	KEYWORD2
settimeofday	KEYWORD2
psramInit	KEYWORD2
BLEAddrToString	KEYWORD2
getAddressType	KEYWORD2
OUICacheWarmup	KEYWORD2
setCacheSize	KEYWORD2
VendorCacheWarmup	KEYWORD2
BLEDevCacheWarmup	KEYWORD2




MAX_BLECARDS_WITH_TIMESTAMPS_ON_SCREEN	LITERAL2
MAX_BLECARDS_WITHOUT_TIMESTAMPS_ON_SCREEN	LITERAL2
BLEDEVCACHE_PSRAM_SIZE	LITERAL2
BLEDEVCACHE_HEAP_SIZE	LITERAL2
BUILD_NEEDLE	LITERAL2
BUILD_SIGNATURE	LITERAL2
IN_CACHE_ANON	LITERAL2
IN_CACHE_NOT_ANON	LITERAL2
NOT_IN_CACHE_ANON	LITERAL2
NOT_IN_CACHE_NOT_ANON	LITERAL2
ALIGN_FREE	LITERAL2
ALIGN_LEFT	LITERAL2
ALIGN_RIGHT	LITERAL2
ALIGN_CENTER	LITERAL2
BLE_ADDR_TYPE_PUBLIC	LITERAL2
BLE_ADDR_TYPE_RANDOM	LITERAL2
BLE_ADDR_TYPE_RPA_PUBLIC	LITERAL2
BLE_ADDR_TYPE_RPA_RANDOM	LITERAL2
BLE_COLLECTOR_DB	LITERAL2
MAC_OUI_NAMES_DB	LITERAL2
BLE_VENDOR_NAMES_DB	LITERAL2



BLE_WHITE	LITERAL1	Constants
BLE_BLACK	LITERAL1	Constants
BLE_GREEN	LITERAL1	Constants
BLE_YELLOW	LITERAL1	Constants
BLE_GREENYELLOW	LITERAL1	Constants
BLE_CYAN	LITERAL1	Constants
BLE_ORANGE	LITERAL1	Constants
BLE_DARKGREY	LITERAL1	Constants
BLE_LIGHTGREY	LITERAL1	Constants
BLE_RED	LITERAL1	Constants
BLE_DARKGREEN	LITERAL1	Constants
BLE_PURPLE	LITERAL1	Constants
BLE_PINK	LITERAL1	Constants
HEADER_BGCOLOR	LITERAL1	Constants
FOOTER_BGCOLOR	LITERAL1	Constants
IN_CACHE_COLOR	LITERAL1	Constants
NOT_IN_CACHE_COLOR	LITERAL1	Constants
ANONYMOUS_COLOR	LITERAL1	Constants
NOT_ANONYMOUS_COLOR	LITERAL1	Constants
BLUETOOTH_COLOR	LITERAL1	Constants
BLE_DARKORANGE	LITERAL1	Constants
BLECARD_BGCOLOR	LITERAL1	Constants
RTC_PROFILE	LITERAL1	Constants
SCAN_DURATION	LITERAL1	Constants
MAX_DEVICES_PER_SCAN	LITERAL1	Constants
MAX_FIELD_LEN	LITERAL1	Constants
MAC_LEN	LITERAL1	Constants
SHORT_MAC_LEN	LITERAL1	Constants
NTP_MENU_NAME	LITERAL1	Constants
BLE_MENU_NAME	LITERAL1	Constants
RTC_SDA	LITERAL1	Constants
RTC_SCL	LITERAL1	Constants
esp_partition_t	LITERAL1	Constants
xSemaphoreHandle	LITERAL1	Constants
timeval	LITERAL1	Constants
timezone	LITERAL1	Constants
HEADER_HEIGHT	LITERAL1	Constants
FOOTER_HEIGHT	LITERAL1	Constants
SCROLL_HEIGHT	LITERAL1	Constants
HEAPMAP_BUFFLEN	LITERAL1	Constants
MIN_SCAN_DURATION	LITERAL1	Constants
MAX_SCAN_DURATION	LITERAL1	Constants
VENDORCACHE_SIZE	LITERAL1	Constants
OUICACHE_SIZE	LITERAL1	Constants
BLEDEVCACHE_SIZE	LITERAL1	Constants
BUILD_TYPE	LITERAL1	Constants
MENU_FILENAME	LITERAL1	Constants
NTP_MENU_FILENAME	LITERAL1	Constants
BLE_MENU_FILENAME	LITERAL1	Constants
WELCOME_MESSAGE	LITERAL1	Constants
BUILD_NTPMENU_BIN	LITERAL1	Constants
HTTP_CODE_OK	LITERAL1	Constants

ICON_APP_X	LITERAL1	Constants
ICON_APP_Y	LITERAL1	Constants
ICON_RTC_X	LITERAL1	Constants
ICON_RTC_Y	LITERAL1	Constants
ICON_BLE_X	LITERAL1	Constants
ICON_BLE_Y	LITERAL1	Constants
ICON_DB_X	LITERAL1	Constants
ICON_DB_Y	LITERAL1	Constants
ICON_R	LITERAL1	Constants
PROGRESSBAR_Y	LITERAL1	Constants
esp_ble_addr_type_t	LITERAL1	Constants
TABLE_CREATION_FAILED	LITERAL1	Constants
INSERTION_FAILED	LITERAL1	Constants
INCREMENT_FAILED	LITERAL1	Constants
INSERTION_IGNORED	LITERAL1	Constants
DB_IS_OOM	LITERAL1	Constants
INSERTION_SUCCESS	LITERAL1	Constants
INCREMENT_SUCCESS	LITERAL1	Constants



setTheme	KEYWORD2
UIUtils	KEYWORD1
BLECardIsOnScreen	KEYWORD2
BLEStateIconSetColor	KEYWORD2
DBStateIconSetColor	KEYWORD2
PrintBLEStateIcon	KEYWORD2
PrintBleScanWidgets	KEYWORD2
PrintDBStateIcon	KEYWORD2
PrintProgressBar	KEYWORD2
accheStats	KEYWORD2
clockSync	KEYWORD2
footerStats	KEYWORD2
headerStats	KEYWORD2
heapGraph	KEYWORD2
init	KEYWORD2
percentBox	KEYWORD2
playIntro	KEYWORD2
printBLECard	KEYWORD2
startBlink	KEYWORD2
stopBlink	KEYWORD2
taskHeapGraph	KEYWORD2
timeStateIcon	KEYWORD2
update	KEYWORD2
SDUpdater	KEYWORD1
SDMenuProgress	KEYWORD2
displayUpdateUI	KEYWORD2
updateFromFS	KEYWORD2
AmigaBallConfig	KEYWORD1
AmigaRulez	KEYWORD1
Points	KEYWORD1
animate	KEYWORD2
calcPoints	KEYWORD2
clearCrescent	KEYWORD2
draw	KEYWORD2
drawWireFrame	KEYWORD2
fillTiles	KEYWORD2
getLat	KEYWORD2
init	KEYWORD2
scaleTranslate	KEYWORD2
setupValues	KEYWORD2
tiltSphere	KEYWORD2
transform	KEYWORD2
BlueToothDeviceHelper	KEYWORD1
getNextCacheIndex	KEYWORD2
init	KEYWORD2
isAnonymous	KEYWORD2
reset	KEYWORD2
set	KEYWORD2
store	KEYWORD2
BlueToothDevice	KEYWORD1
ScrollableOutput	KEYWORD1
print	KEYWORD2
println	KEYWORD2
scrollNextPage	KEYWORD2
setupScrollArea	KEYWORD2
TimeActivity	KEYWORD1








#######################################
# Syntax Coloring Map For IRremote
#######################################

#######################################
# Datatypes (KEYWORD1)
#######################################

decode_results	KEYWORD1
IRrecv	KEYWORD1
IRsend	KEYWORD1
Ultrasonic	KEYWORD1
DateTime	KEYWORD1
RTC_DS1307	KEYWORD1
RTC_Millis	KEYWORD1
LiquidCrystal	KEYWORD1
begin	KEYWORD2
clear	KEYWORD2
home	KEYWORD2
print	KEYWORD2
setCursor	KEYWORD2
cursor	KEYWORD2
noCursor	KEYWORD2
blink	KEYWORD2
noBlink	KEYWORD2
display	KEYWORD2
noDisplay	KEYWORD2
autoscroll	KEYWORD2
noAutoscroll	KEYWORD2
leftToRight	KEYWORD2
rightToLeft	KEYWORD2
scrollDisplayLeft	KEYWORD2
scrollDisplayRight	KEYWORD2
createChar	KEYWORD2
setBacklight	KEYWORD2
#######################################
# Methods and Functions (KEYWORD2)
#######################################

blink13	KEYWORD2
decode	KEYWORD2
enableIRIn	KEYWORD2
resume	KEYWORD2
enableIROut	KEYWORD2
sendNEC	KEYWORD2
sendSony	KEYWORD2
sendSanyo KEYWORD2
sendMitsubishi KEYWORD2
sendRaw	KEYWORD2
sendRC5	KEYWORD2
sendRC6	KEYWORD2
sendDISH KEYWORD2
sendSharp KEYWORD2
sendPanasonic KEYWORD2
sendJVC KEYWORD2
Timing	KEYWORD2
Ranging	KEYWORD2

year	KEYWORD2
month	KEYWORD2
day	KEYWORD2
hour	KEYWORD2
minute	KEYWORD2
second	KEYWORD2
dayOfWeek	KEYWORD2
secondstime	KEYWORD2
unixtime	KEYWORD2
begin	KEYWORD2
adjust	KEYWORD2
isrunning	KEYWORD2
now	KEYWORD2
read 	KEYWORD2
begin	KEYWORD2

#
#######################################
# Constants (LITERAL1)
#######################################

NEC	LITERAL1
SONY	LITERAL1
SANYO LITERAL1
MITSUBISHI LITERAL1
RC5	LITERAL1
RC6	LITERAL1
DISH LITERAL1
SHARP LITERAL1
PANASONIC LITERAL1
JVC LITERAL1
UNKNOWN	LITERAL1
REPEAT	LITERAL1
CM	LITERAL1	Constants
INC	LITERAL1	Constants